BBBBBBBBBBBBBBBBBB
BEEEEEEEEEEEEEEEEB
BEEEERRRRREEEGEEEB
BEEEEEEEEREEEGEEEB
BEEEEGGGEREEEGEEEB
BEEEEEEEEREEEGEEEB
BEEEEEEEEEEEEEEEEB
BBBBBBBBBBBBBBBBBB
